NO ./textures/North.xpm
SO ./textures/South.xpm
WE ./textures/West.xpm
EA ./textures/East.xpm

F 255,0,0
C 255,255,255

1111111111111
1N00001000001
1011101111101
1000100000101
1010111110101
1010000010101
1110111010111
1000001000001
1011111011101
1010000000101
1010111110101
1000000000001
1111111111111
