WE ./textures/West.xpm
EA ./textures/East.xpm
NO ./textures/North.xpm
SO ./textures/South.xpm


F 0,0,255
C 204,0,0

1111111111
1000S00001
1000000001
1000000001
1000000001
1111111111