NO ./textures/North.xpm
SO ./textures/South.xpm
WE ./textures/West.xpm
EA ./textures/East.xpm

F 255,0,0
C 255,165,0

1111111111
1000S00001
1011111101
1000000001
1000000001
1111111111